MAP_FOR_SNAKE
house 20 30
000000000000000000000000000000
000000000000000000000000000000
000111111111110011111000000000
000100000000000000001000000000
000100000000000000001110000000
000100010000000000100010000000
000122000000000000000010000000
000122000000000000000000000000
000111111100001111111110000000
000100000000000000000010000000
000000010000001000000010000000
000000010000001000000010000000
000000010000001000000000000000
000000010000001000000000000000
000100000000000000000010000000
000111111111111111111110000000
000000000000000000000000111000
000000000000000000000000101000
000000000000000000000000111000
000000000000000000000000000000